4 grass.png 1 flowers.png 1 road.png 1 wall.png 0
3 3 3 3 3 3 3 3 3 3 3 3 3 3 3 3 3 3 3 3
3 0 0 0 0 0 0 0 0 0 0 0 0 0 0 0 0 1 0 3
3 0 0 0 0 0 3 3 3 3 3 0 0 0 0 0 0 0 0 3
3 3 3 3 0 0 0 0 0 0 3 0 0 0 1 0 0 0 0 3
3 0 0 3 3 3 3 0 3 3 3 0 1 0 0 0 0 1 0 3
3 0 0 0 0 0 0 0 0 0 3 0 0 0 0 0 0 0 0 3
3 0 0 3 3 3 3 3 3 3 3 3 3 3 3 3 3 3 3 3
3 2 2 2 2 2 2 2 2 2 2 2 2 2 2 2 2 2 2 3
3 2 2 2 2 2 2 2 2 2 2 2 2 2 2 2 2 2 2 3
3 0 0 0 0 0 0 0 0 0 0 0 0 0 0 0 0 2 2 3
3 0 0 0 0 0 1 0 0 0 0 0 0 1 0 0 0 2 2 3
3 0 0 1 0 0 0 0 0 0 0 0 0 0 0 0 0 2 2 3
3 0 0 0 0 0 0 0 0 1 0 0 0 0 0 0 0 2 2 3
3 0 0 0 0 1 0 0 0 0 0 0 0 0 0 0 0 2 2 3
3 0 0 0 0 0 0 0 0 0 0 0 1 0 0 0 0 2 2 3