5 grass.png 1 platform.png 1 road.png 1 train_roof.png 0 wall.png 0
4 0 0 0 0 0 0 0 0 0 0 0 0 0 0 0 0 2 2 4
4 0 0 0 0 0 0 0 0 0 0 0 0 0 0 0 0 2 2 4
4 0 0 2 2 2 2 2 2 2 2 2 2 2 2 2 2 2 2 4
4 0 0 2 2 2 2 2 2 2 2 2 2 2 2 2 2 2 2 4
4 0 0 2 2 0 0 0 0 0 0 0 0 0 0 0 0 0 0 4
4 0 0 2 2 0 0 0 0 0 0 0 0 0 0 0 0 0 0 4
4 0 0 2 2 0 0 0 0 0 0 0 0 0 0 0 0 0 0 4
4 0 0 2 2 0 0 0 0 0 0 0 0 0 0 0 0 0 0 4
4 0 0 2 2 0 0 0 0 0 0 0 0 0 0 0 0 0 0 4
4 0 0 2 2 0 0 4 4 4 4 4 4 4 4 4 4 4 4 4
1 1 1 1 1 1 1 1 1 1 1 1 1 1 1 1 1 1 1 1
1 1 1 1 1 1 1 1 1 1 1 1 1 1 1 1 1 1 1 1
1 1 1 1 1 1 1 1 1 1 1 1 1 1 1 1 1 1 1 1
1 1 1 1 1 1 1 1 1 1 1 1 1 1 1 1 1 1 1 1
3 3 3 3 3 3 3 3 3 3 3 3 3 3 3 3 3 3 3 3