3 grass.png 1 flowers.png 1 wall.png 0
2 2 2 2 2 2 2 2 2 2 2 2 2 2 2 2 2 2 2 2
2 0 1 1 1 0 1 0 1 0 1 1 1 0 0 0 0 0 0 2
2 0 0 1 0 0 1 0 1 0 1 0 0 0 0 0 0 0 0 2
2 0 0 1 0 0 1 1 1 0 1 1 0 0 0 0 0 0 0 2
2 0 0 1 0 0 1 0 1 0 1 0 0 0 0 0 0 0 0 2
2 0 0 1 0 0 1 0 1 0 1 1 1 0 0 0 0 0 0 2
2 0 0 0 0 0 0 0 0 0 0 0 0 0 0 0 0 0 0 2
2 0 0 0 0 1 1 1 0 1 0 0 1 0 1 1 0 0 0 2
2 0 0 0 0 1 0 0 0 1 1 0 1 0 1 0 1 0 0 2
2 0 0 0 0 1 1 0 0 1 0 1 1 0 1 0 1 0 0 2
2 0 0 0 0 1 0 0 0 1 0 0 1 0 1 0 1 0 0 2
2 0 0 0 0 1 1 1 0 1 0 0 1 0 1 1 0 0 0 2
2 0 0 0 0 0 0 0 0 0 0 0 0 0 0 0 0 0 0 2
2 0 0 0 0 0 0 0 0 0 0 0 0 0 0 0 0 0 0 2
2 2 2 2 2 2 2 2 2 2 2 2 2 2 2 2 2 2 2 2